....................
....................
...####......#......
...##........#......
...#.........#......
...######....#......
........#....#......
........#....#......
....................
................#...
................#...
................#...
................#...
............#####...
............#.......
............#.......
....................
....................
....................
....................