....................
......###########...
....................
....................
...####.............
...#................
...#................
...#................
...#................
...#................
...#................
...#................
...#................
...#................
....................
......##############
....................
....................
....................
...........#########