....................
.....###########....
...............#....
...............#....
...............#....
...............#....
...............#....
...............#....
...............#....
...............#....
...............#....
#..............#....
#..............#....
#..............#....
#...................
#...................
#...................
#...................
#...................
#..................#