....................
....................
..#...#.............
..#...#.............
..#...#.............
..#...#.............
..#...#.............
..#...#.............
..#...#.............
..#...#.............
....................
....................
...........####.....
....................
....................
....................
....................
......####..##......
....................
...........#........